R 170000 2345

NO ./texture/redbrick.xpm
SO ./texture/wood.xpm
WE ./texture/colorstone.xpm
EA ./texture/bluestone.xpm

S ./texture/barrel.xpm
F 225,225,225
C 0,0,0

11111111
122N1001
10000011111
11000001001
10000001001
10200000001
10002001111
11111111