R 1920 1080

NO ./texture/bluestone.xpm
SO ./texture/greystone.xpm
WE ./texture/greystone.xpm
EA ./texture/greystone.xpm

S ./texture/greystone.xpm
F 220,100,0
C 225,30,0

11111111
10001001
10000011
11000001
10000001
1000W001
10000001
11111111