R 100000 1000000

F 220,225,221
C 0,0,0

NO ./texture/redbrick.xpm
SO ./texture/wood.xpm
WE ./texture/colorstone.xpm
EA ./texture/bluestone.xpm

S ./texture/barrel.xpm

11111111111
12200002001
10000111101
110001  101
10102011101
10200E22221
10002021111
11111111