R 100000 1000000

F 220,225,221
C 0,0,0

NO ./texture/redbrick.xpm
SO ./texture/wood.xpm
WE ./texture/colorstone.xpm
EA ./texture/bluestone.xpm

S ./texture/barrel.xpm

11111111111
12000000001
10000111101
110001  1011111111
10100011100000000111
10000W000011111001001
10000001111   10000021
1111001       10000001
   1000111111110010001
   100000000000001111
   111111111111111